11111111111111111
10C00000000000001
1PE00000000000000
11111111111111111
