11111111111111111
1111111100C111111
0111111111P111111
0111111111EC11111
11111111111111111
