1111111111111111
P00E00000C000001
1000000100000001
1111111111111100
