1111111111111111111111111111111
1P11111111111111111111111111111
10P0000000000000000000000000001
10000000000000000000000000000E1
1CCCCCCCCCCCCCCCCCCCCCCCCCCCCC1
1111111111111111111111111111111
