11111111111111111111111111
10000000000000000000000011
10000000000000000000000001
111111111110000000000000C1
1111E111111000000000000P01
11111111111111111111111111
