11111111111111111111111111111111111111111111111111111111111111111111111111111
10000000000000000000000000000000000000000PCE111111111111111111111111111111111
11111111111111111111111111111111111111111111111111111111111111111111111U11111
11111111111111111111111111111111111111111111111111111111111111111111111111111
