1111111111111111111
1000C000000000C0001
1100000100100000011
1110001100110000111
11110000PE000001111
1110001100110000111
1100000100100000001
1000C000000000C0011
1111111111111111111
